  "###################",
  "#...###########...#",
  "#...#######.###...#",
  "############.######",
  "############.######",
  "##########....#####",
  "###################",
  "#####G####.##.#####",
  "#####.#######.#####",
  "#####.#######..####",
  "#####.#.#####.#####",
  "#####.#.###.#######",
  "####.%##.#.....####",
  "#####G####o##.#####",
  "###################",